9
5
4
4
5
3
4
4
3
000000000
000000000
000020000
000010000
005111300
000010000
000040000
000000000
000000000
