7
3
3
4
2
5
3
000000000
000000000
000010000
000111000
000040000
000020000
000030000
000000000
000000000
