7
2
5
3
5
4
5
0000000000
0000000000
0000000000
0000000000
0000001000
0011124300
0000000000
0000000000
0000000000
0000000000
