7
2
4
4
4
6
4
000000000
000000000
000000000
001111100
004030200
000000000
000000000
000000000
000000000